11111111111
10010000PC1
10000100111
100000011E1
1C000C11C01
11111111111