11111111111111
10001100000C01
10000000000111
1P00011E0C0001
11111111111111