11111111111111
1E000000000C01
10000000000111
1P0001100C0001
100111111000C1
11111111111111