1111111111111
1P011110000C1
1000000000011
1E00001111E11
1111111111111