111111111111
1110000000C1
1C0000001111
1P0000C00001
11111EP00001
111111111111