111111111111
111000000011
100000001111
1P0001100001
11111E000001
111111111111