11111111111111
10001100000C01
00000000000111
1P00011E0C0000
100001111000C1
11111111111111